4  3  3  3  3  3  3  3  3  3  3  3  3  3  3  3  3  3  5
2  1  1  1  2  1  1  1  1  1  1  1  1  1  1  1  1  1  2
2  1  1  1  2  1  1  1  1  1  1  1  1  1  1  1  1  1  2
2  1  1  1  2  1  1  1  1  1  1  1  1  1  1  1  1  1  2
2  1  1  1  2  1  1  1  1  1  1  1  1  1  1  1  1  1  2
2  1  1  1  2  1  1  1  1  1  1  1  1  1  1  1  1  1  2
2  1  1  1  2  1  1  1  1  1  1  1  1  1  1  1  1  1  2
2  3  3  3  14  3  3  3  3  15 3  3  3  3  3  3  9  1  2
2  1  1  1  1  1  1  1  1  2  1  1  1  1  1  1  1  1  2
2  1  1  1  1  1  1  1  1  2  1  1  1  1  1  1  1  1  2
2  1  1  1  1  1  1  1  1  2  1  1  1  1  1  1  1  1  2
2  1  1  1  1  1  1  1  1  2  1  1  1  1  1  1  1  1  2
2  1  1  1  1  1  1  1  1  2  1  1  1  1  1  1  1  1  2
2  1  1  1  1  1  1  1  1  1  1  1  1  1  1  1  1  1  2
2  1  1  1  1  1  1  1  1  1  1  1  1  1  1  1  1  1  2
6  3  3  3  3  3  3  3  3  1  3  3  3  3  3  3  3  3  7
21 21 21 21 21 21 21 21 21 21 21 21 21 21 21 21 21 21 21 
20 20 20 20 20 20 20 20 20 20 20 20 20 20 20 20 20 20 20
16 17 18 18 16 17 18 18 16 17 18 18 16 17 18 18 16 17 18
19 19 19 19 19 19 19 19 19 19 19 19 19 19 19 19 19 19 19