1  1  1  1  1  1  1  1  1  1  1  1  1  1  1  1  1  1  1
1  4  3  3  3  3  3  3  3  3  3  3  3  3  3  3  3  5  1
1  2  1  1  1  1  1  1  1  1  1  1  1  1  1  1  1  2  1
1  2  1  1  1  1  1  1  1  10 1  1  1  1  1  1  1  2  1
1  2  1  1  1  1  1  1  1  2  1  1  1  1  1  1  1  2  1
1  2  1  1  1  1  1  1  1  2  1  1  1  1  1  1  1  2  1
1  2  1  1  1  1  1  1  1  2  1  1  1  1  1  1  1  2  1
1  2  1  1  1  8  3  3  3  12 3  3  3  9  1  1  1  2  1
1  2  1  1  1  1  1  1  1  2  1  1  1  1  1  1  1  2  1
1  2  1  1  1  1  1  1  1  2  1  1  1  1  1  1  1  2  1
1  2  1  1  1  1  1  1  1  2  1  1  1  1  1  1  1  2  1
1  2  1  1  1  1  1  1  1  11 1  1  1  1  1  1  1  2  1
1  2  1  1  1  1  1  1  1  1  1  1  1  1  1  1  1  2  1
1  2  1  1  1  1  1  1  1  1  1  1  1  1  1  1  1  2  1
1  6  3  3  3  3  3  3  9  1 8  3  3  3  3  3  3  7  1
1  1  1  1  1  1  1  1  1  1  1  1  1  1  1  1  1  1  1
