0  0  0  0  0  0  0  0  0  0  0  0  0  0  0  0  0  0  0
0  1  1  1  1  1  1  1  1  1  1  1  1  1  1  1  1  1  0
0  1  1  1  1  1  1  1  1  1  1  1  1  1  1  1  1  1  0
0  1  1  1  1  1  1  1  1  1  1  1  1  1  1  1  1  1  0
0  1  1  1  1  1  1  1  1  1  1  1  1  1  1  1  1  1  0
0  1  1  1  1  1  1  1  1  1  1  1  1  1  1  1  1  1  0
0  1  1  1  1  1  1  1  1  1  1  1  1  1  1  1  1  1  0
0  1  0  0  0  0  0  0  0  0  0  0  0  0  0  0  0  1  0
0  1  1  1  1  1  1  1  1  0  1  1  1  1  1  1  1  1  0
0  1  1  1  1  1  1  1  1  0  1  1  1  1  1  1  1  1  0
0  1  1  1  1  1  1  1  1  0  1  1  1  1  1  1  1  1  0
0  1  1  1  1  1  1  1  1  0  1  1  1  1  1  1  1  1  0
0  1  1  1  1  1  1  1  1  0  1  1  1  1  1  1  1  1  0
0  1  1  1  1  1  1  1  1  0  1  1  1  1  1  1  1  1  0
0  1  1  1  1  1  1  1  1  0  1  1  1  1  1  1  1  1  0
0  0  0  0  0  0  0  0  0  0  0  0  0  0  0  0  0  0  0
21 21 21 21 21 21 21 21 21 21 21 21 21 21 21 21 21 21 21 
20 20 20 20 20 20 20 20 20 20 20 20 20 20 20 20 20 20 20
16 17 18 18 16 17 18 18 16 17 18 18 16 17 18 18 16 17 18
19 19 19 19 19 19 19 19 19 19 19 19 19 19 19 19 19 19 19